tilemap1.png 6 4 64 64
12
12
13
20 20
0 5 5 5 5 5 5 5 5 5 5 5 5 5 5 5 5 5 5 5
5 0c 0 0 13 13 13 5 5 5 5 13 13 13 5 0 0 0c 0 5
5 13 5 0 5 5 13 5 13 13 5 13 5 5 5 0 5 5 0 5
5 13 5 0 0 0 13 5 0 0 5 13 0 0 0 0 5 13 0 5
5 13 5 5 5 0 5 5 13 0 5 13 5 5 5 0 5 13 0 5
5 0 0 0 0 0c 5 5 13 0 0c 0 0 0 5 0 0 0 0c 5
5 5 5 5 5 0 5 5 13 13 13 13 5 0 5 13 13 13 5 5
5 13 13 13 5 0c 13 5 0c 0c 0c 13 5 0 5 5 5 5 5 5
5 0 0 5 0 0 13 5 5 5 0 13 5 0 0 0 0 0 0c 5
5 0 5 5 5 0 5 5 5 5 0 5 5 5 5 5 5 5 0 5
5 0 0 0 5 0 0 0 0 5 0 0 0c 0 0 13 13 5 0 5
5 5 5 0 5 5 5 5 0 5 5 5 5 5 0 5 0 5 0 5
5 13 0c 0 0 0 13 5 0 0 0 0 0 5 0 5 0 5 0 5
5 13 5 5 5 0 5 5 5 5 5 5 0 5 0 5 0 5 0 5
5 0 0 0 5 0 0 0c 0 0 0 5 0 5 0 0 0 5 0 5
5 5 5 0 5 5 5 5 5 5 0 5 0 5 5 5 0 5 0 5
5 13 0 0 0c 13 13 13 13 5 0 0 0 13 13 5 0 0 0 5
5 13 13 13 5 5 5 5 13 5 13 5 5 5 5 5 5 5 13 5
5 0 0 0 5 0 0 0 0c 5 0 0 0 0c 0 0 0 5 0 5
5 5 5 5 5 5 5 5 5 5 5 5 5 5 5 5 5 5 5 5
