tilemap1.png 6 4 64 64
12
12
13
20 20
5 5 5 5 5 5 5 5 5 5 5 5 5 5 5 5 5 5 5 5
5 13 13 13 5 5 5 5 13 13 13 5 5 13 13 13 5 5 5 5
5 13 0 13 5 12 12 12 12 0 13 5 5 13 0 13 5 5 5 5
5 13 0 13 5 12 0 0 0 0 13 13 13 13 0 13 5 5 5 5
5 13 0 13 5 12 0 2 2 0 5 5 5 5 0 13 13 13 5 5
5 13 0 13 5 12 0 2 2 0 5 5 5 5 0 0 0 13 5 5
5 13 0 13 5 12 0 0c 0c 0 5 5 5 5 4 4 0 13 5 5
5 13 0 13 5 12 12 12 12 12 5 5 5 5 4 4 0 13 5 5
5 13 0 13 13 13 5 5 5 5 5 13 13 13 3 3 0 13 5 5
5 13 0 0 0 13 5 13 13 13 5 13 0 0 3 3 0 13 5 5
5 13 0 4 0 13 5 13 0 13 5 13 0 4 3 3 0 13 5 5
5 13 0 4 0 13 5 13 0 13 5 13 0 4 3 3 0 13 5 5
5 13 0 4 0 13 5 13 0 13 5 13 0 4 3 3 0 13 5 5
5 13 0 0 0 13 5 13 0 13 5 13 0 0 3 3 0 13 5 5
5 13 13 13 13 13 5 13 0 13 5 13 13 13 13 13 0 13 5 5
5 5 5 5 5 5 5 13 0 13 5 5 5 5 5 5 0 13 5 5
5 5 5 5 5 5 5 13 0 13 13 13 13 13 13 13 0 13 5 5
5 5 5 5 5 5 5 13 0 0 0 0 0 0 0 0 0 13 5 5
5 5 5 5 5 5 5 13 13 13 13 13 13 13 13 13 13 13 5 5
5 5 5 5 5 5 5 5 5 5 5 5 5 5 5 5 5 5 5 5